12345678111111111111111111111111111111111111111111111111111111111111111111111111
1        9                                                                     1
19  9555555555445555555555  5555555555555555555555555555555555555555555555555  1
13  35          5        5   52                                             5  1
1   35          5        5    33333333333333333333333333333333333           5  1
1   35  55   55555  5    5                                         5555555555  1
1   35  55  5       5    5  5555555   555555555555 555555555555   55           1
1   35  55  5       5    5     555555 5                            5  5555555551
1   555555445775  555555 5  55  55554  5555555555   5445555555555555   5   85  1
1       5                   555  5552                              5  5  5555  1
1   53  5                   5555  553   222222      555555555      5  5  5  5441
1   53  555555555555555     55555  352  55   5   3  2       3          5  5    1
1   55       5     4       5       32   33 333   3  2  3    5             5    1
1   5        5     4        5  5555555  55 555   3     3  5   5 2           5  1
1   5   555555555555555556665  5                 3     3  5 2                  1
1   5  5                       5  4              3     3  5  2                 1
1   5  54455554455555 555555555   555555555      3     3  5     23  5555       1
1   5  5     5    4638  7         4   5          3     3  5        4    3      1
1   54455555555577555555755555 555555555555555   3     3           433333      1
1   5          4  5     5      5          555     3     3555555555     2       1
1   5          4  555 5555555555     5            3              5    2        1
1   555544555555                   5   555555    5     3555555  5     2        1
1            5555555555555555555   5             5     3     5  5      3       1
1            5       33333333                    533333355545555       2       1
15555555555555   22           77777755555        5555555                 7     1
1         5  55555555555       5                 5                       7     1
1445555555555        5  77777755555              5   5555                 7    1
1  4  5     5        5                           5   4         55         7    1
1  4   5   5555555544555777777755555             5   4         563377777777    1
1  7                               5             5   5  5       56         4   1
15577775   66666     7          5                2   5  5      5644228888887   1
1              5    7888885555555  5             2   5  5               4      1
1  754455232323                 4  4             244555544555555555555555      1
1  7    44                      4  4             5                       5     1
1  555555555555555555555555555559  955555555445555555555555555555555555555555551
1                      9                       9                               1
11111111111111111111111111111111111111111111111111111111111111111111111111111111